E00000000000
111100000111
100001110110
101111110000
000100001011
110001010011
111011000110
001001010110
000011000110
111010011110
111010000111
11100001000S