E00B111111
B000B11101
1B0B111101
1000B11101
1100000101
11110B0001
11B11B0111
11B00B0B11
S000110B11
11100000B1